11111111111111111111111111111111111111111111111111111111111111111111111111111111111111111
10000000000000000000000000000000000000000000000000000000000000000000000000000000000000001
10000000000000000000000000000000000000000000000000000000000000000000000000000000000000001
10000000000000000000000000000000000000000000000000000000000000000000000000000000000000001
10000000000000000000000000000000000000000000000000000000000000000000111100000000000000001
10000000000000000000000000000000000000000000000000000000000000000111111111000000000000001
10000000000000000000000000000000000000000000000000000000000000000011111111110000000000001
10000000000000001111000000000000000000000000000000000000000000000011111111110000000000001
10000000001100000110000011000000000000000000000000000000000000000001111111100000000000001
10000000011110000000000111100000000000000000000000000000000000000000001111000000000000001
10000000001100110000000011000000000000000000000000000000000000000000000000000000000000001
10000000000001111000000000000000000000000000000000000000000000000000000000000000000000001
10000000000000110000000000000000000000000000000000000000000000000000000000000000000000001
10000000000000000000000110000000000000000000000000000000000000000000000000000000000000001
10000000000000000000001111000000000000000000000000000000000000000000000000000000000000001
10000000000000000000000110000000000000000000000000000000000000000000000000000000000000001
10000000000000000000000000000000000000000000000000000000000000000000000000000000000000001
10000000000000000000000000000000000000000000000000000000000000000000000000000000000000001
10000000000000000000000000000000000000000000000000000000000000000000000000000000000000001
10000000000000000000000000000000000000000000000000000000000000000000000000000000000000001
10000000000000000000000000000000000000000000000000000000000000000000000000000000000000001
10000000000000000000000000111111100000000000000000000000000000000000000000000000000000001
10000000000000000000000011111111110000000000000000000000000000000000000000000000000000001
10000000000000000000000011111111110000000000000000000000000000000000000000000000000000001
10000000000000000000000011111111110000000000000000000000000000000000000000000000000000001
10000000000000000000000011111111110000000000000000000000000000000000000000000000000000001
10000000000000000000000000000000000000000000000000000000000000000000000000000000000000001
10000000000000000000000000000000000000000000000000000000000000000000000000000000000000001
10000000000000000000000000000000000000000000000000000000000000000000000000000000000000001
11111111111111111111111111111111111111111111111111111111111111111111111111111111111111111
