+------------------------+
|                        |
|          ##            |
|         ####           |
|   ##     ||     ##     |
|  ####          ####    |
|   ||  ##        ||     |
|      ####              |
|       ||               |
|                        |
+------------------------+